.................................
#################################
1_________#_____________________X
#######___#________##############
......#___#________#.............
......#___#________#.............
......#____________#.............
......##############.............
.................................