###################################################
#_________________________________________________#
#_________________________________________________#
#_________________________________________________#
#_________________________________________________#
#_________________________________________________#
#_________________________________________X_______#
#_________________________________________________#
#______________1__________________________________#
#_________________________________________________#
#_________________________________________________#
#_________________________________________________#
#_________________________________________________#
#_________________________________________________#
#_________________________________________________#
#_________________________________________________#
#_________________________________________________#
###################################################