....................
####################
#_X________________#
#########__________#
........#__________#
........#__________#
........#__________#
........#__________#
........####_______#
...........#_______#
...........#_______#
....########_______#
#####______________#
#1_________________#
####################